Gs, Gs, Gs, Gs, Rb, Xoc, Xoc, Xoc, Xoc, Xoc, Xoc, Xoc, Xoc, Xoc, Xoc, Xoc, Xoc, Xoc, Xoc, Xoc, Xoc, Xoc
Gs, 1 Ke, Ce, Ce, Gg, Xoc, Xoc, Xoc, Xoc, Xoc, 2 Kud, Xoc, Xoc, Xoc, Xoc, Xoc, Xoc, Xoc, Xoc, Xoc, Xoc, Xoc
Gs, Ce, Ce, Ce, Gg, Xoc, Xoc, Xoc, Xoc, Cud, Cud, Rd, Rd, Xoc, Xoc, Xoc, Xoc, Xoc, Xoc, Xoc, Xoc, Xoc
Gg, Rb^Vct, Rrc, Rrc, Gg, Xoc, Xoc, Xoc, Xoc, Xoc, Xoc, Gg, Rd, Gg, Gg, Xoc, Xoc, Xoc, Xoc, Xoc, Xoc, Xoc
Gg, Rb, Rrc, Rrc, Gg, Gg, Gg, Xoc, Gg, Xoc, Gg, Xoc, Gg, Rd, Gg, Xoc, Xoc, Xoc, Xoc, Xoc, Xoc, Xoc
Gg, Gg, Rrc, Rrc, Rrc, Gg^Fet, Rrc, Gg, Rrc, Gg, Rrc, Gg, Rrc, Rd, Gg, Xoc, Xoc, Xoc, Xoc, Xoc, Xoc, Xoc
Gg, Gg, Rd, Rrc, Rrc, Rrc, Rrc, Rrc, Rrc, Rrc, Rrc, Rrc, Rrc, Rrc, Rrc, Gg, Gg, Xoc, Xof, Xoc, Xoc, Xoc
Rd, Rd, Gg, Gg, Gg, Rrc, Gg, Rrc, Gg, Rrc, Gg, Rrc, Gg, Rrc, Rrc, Rrc, Rrc, Gg, Gg, Xof, Gg, Gg
Gg, Rd, Gg, Xoc, Xoc, Gg, Xoc, Gg, Xoc, Gg, Xoc, Gg, Xoc, Gg, Gg, Rrc, Rrc, Rrc, Rrc, Gg, Rrc, Rrc
Gg, Rd, Gg, Xoc, Cud, Xoc, Xoc, Xoc, Xoc, Xoc, Xoc, Xoc, Xoc, Xoc, Xoc, Gg, Gg, Rrc, Rrc, Rrc, Rrc, Rrc
Gg, Rd, Rd, Cud, 3 Kud, Cud, Rd, Gg, Gg, Xoc, Xoc, Xoc, Xoc, Xoc, Xoc, Xoc, Xoc, Gg, Rrc, Rrc, Rrc, Rrc
Xoc, Xoc, Xoc, Cud, Xoc, Cud, Xoc, Rd, Gg, Xoc, Xoc, Xoc, Xoc, Xoc, Xoc, Xoc, Xoc, Gg, Rrc, Rrc, Rrc, Rrc
Xoc, Xoc, Gg, Xoc, Xoc, Xoc, Xoc, Rd, Rd, Gg, Gg, Xoc, Gg, Xoc, Gg, Xoc, Gg, Gg, Rrc, Rrc, Rrc, Rrc
Re^Gvs, Re^Gvs, Gg, Gg, Gg, Gg, Gg, Gg, Rrc, Gg, Rrc, Gg, Rrc, Gg, Rrc, Gg, Rrc, Rrc, Rrc, Rrc, Rrc, Rrc
Re^Gvs, Re^Gvs, Rrc, Gg^Fet, Rrc, Rrc, Rrc, Rrc, Rrc, Rrc, Rrc, Rrc, Rrc, Rrc, Rrc, Rrc, Rrc, Rrc, Gg, Gg, Gg, Gg
Rrc, Rrc, Rrc, Rrc, Ce, Rrc, Ce, Rrc, Gg^Fet, Rrc, Gg, Rrc, Gg, Rrc, Gg, Rrc, Gg, Rd, Xoc, Xoc, Xoc, Xoc
Gg, Rb, Rrc^Vhc, Rr, Rrc, Ce, Ke, Rrc, Gg, Gg, Xoc, Gg, Xoc, Gg, Xoc, Gg, Rd, Rd, Gg, Xoc, Xoc, Xoc
Wwg^Bsb/, Wwg^Bsb/, Wwg, Rr, Rr^Vhc, Ce, Rrc, Rp, Gg, Xoc, Xoc, Xoc, Xoc, Xoc, Gg, Gg, Rd, Gg, Xoc, Xoc, Xoc, Xoc
Wog, Wog, Wwg^Bsb/, Wwg^Bsb/, Wwrg, Rr, Rr^Vhc, Rrc, Gg, Xoc, Xoc, Xoc, Cud, Cud, Cud, Rd, Xoc, Xoc, Xoc, Xoc, Xoc, Xoc
Wog, Wog^Bsd, Wog, Wog, Wwg^Bsb/, Wwg^Bsb/, Wwg^Bsd, Rb, Gg, Xoc, Xoc, Xoc, Xoc, 4 Kud, Xoc, Xoc, Xoc, Xoc, Xoc, Xoc, Xoc, Xoc
Wog, Wog, Wog, Wog^Bsd, Wog, Wog, Wwg, Gg, Gg, Gg, Hd^Dr, Xoc, Xoc, Xoc, Xoc, Xoc, Xoc, Xoc, Xoc, Xoc, Xoc, Xoc
Wog, Wog, Ww, Wog, Wog, Wog, Wwg, Rb, Gg, Gg, Gg, Xoc, Xoc, Xoc, Xoc, Xoc, Xoc, Xoc, Xoc, Xoc, Xoc, Xoc
