Wo, Wo, Wo, Wo, Wo, Wo, Wo, Wo, Wo, Wo, Wo, Wo, Wo, Wo, Wo, Wo, Wo, Wo, Wo, Wo, Wo, Wo, Wo, Wo, Wo, Wo
Wo, Wo, Wo, Wo, Wo, Wo, Wo, Wo, Wo, Wo, Wo, Wo, Wo, Wo, Wo, Wo, Wo, Wo, Wo, Wo, Wo, Wo, Wo, Wo, Wo, Wo
Wo, Wo, Wo, Wo, Wo, Wo, Wo, Wo, Wo, Wo, Wo, Wo, Wo, Wo, Wo, Wo, Wo, Wo, Wo, Wo, Wo, Wo, Wo, Wo, Wo, Wo
Wo, Wo, Wo, Wo, Wo, Wo, Wo, Wo, Wo, Wo, Wo, Wo, Wo, Wo, Wo, Wo, Wo, Wo, Wo, Wo, Wo, Wo, Wo, Wo, Wo, Wo
Wo, Wo, Wo, Wo, Wo, Wo, Wo, Wo, Wo, Wo, Wo, Wo, Wo, Wo, Wo, Wo, Rd, Xom, Xom, Wo, Wo, Wo, Wo, Wo, Wo, Wo
Wo, Wo, Wo, Wo, Wo, Wo, Wo, Wo, Wo, Wo, Wo, Wo, Wo, Wo, Rd, Rd, Ce, Iwr, Iwr^Vyb, Xom, Wo, Wo, Wo, Wo, Wo, Wo
Wo, Wo, Wo, Wo, Wo, Wo, Wo, Wo, Wo, Wo, Wo, Wo, Rd, Rd^Vyb, Re, Ce, 1 Ke, Ce, Iwr, Xom, Wo, Wo, Wo, Wo, Wo, Wo
Wo, Wo, Wo, Wo, Wo, Wo, Wo, Wo, Wo, Wo, Rd, Rd^Vyb, Re, Re, Re, Ce, Ce, Ce, Rd, Xom, Wo, Wo, Wo, Wo, Wo, Wo
Wo, Wo, Wo, Wo, Wo, Wo, Wo, Wo, Rd, Rd^Vyb, Re, Re, Xom, Re, Re, Re, Rd^Vyb, Rd, Wo, Wo, Wo, Wo, Wo, Wo, Wo, Wo
Wo, Wo, Wo, Wo, Wo, Wo, Xom, Rd, Re, Re, Re, Re, Re, Re, Rd^Vyb, Rd, Wo^Bp|, Wo, Wo, Wo, Wo, Wo, Wo, Wo, Wo, Wo
Wo, Wo, Wo, Wo, Wo, Wo, Xom, Re, Re, Xom, Re, Re, Rd^Vyb, Rd, Wo^Bp|, Wo, Wo^Bp|, Wo, Wo, Wo, Wo, Wo, Wo, Wo, Wo, Wo
Wo, Wo, Wo, Wo, Wo, Wo, Xom, Re, Re, Re, Rd, Rd, Wo, Wo, Wo^Bp|, Wo, Wo^Bp|, Wo, Wo, Wo, Wo, Wo, Wo, Wo, Wo, Wo
Wo, Wo, Wo, Wo, Wo, Wo, Wo, Xom, Xom, Rd, Wo, Wo, Xom, Wo, Wo^Bp|, Wo, Wo^Bp|, Wo, Wo, Wo, Wo, Wo, Wo, Wo, Wo, Wo
Wo, Wo, Wo, Wo, Wo, Wo, Wo, Wo, Wo, Wo, Xom, Xom, Re, Rd, Rd^Vyb, Wo, Wo^Bp|, Wo, Wo, Wo, Wo, Wo, Wo, Wo, Wo, Wo
Wo, Wo, Wo, Wo, Xom, Wo, Wo, Wo, Wo, Wo, Xom, Re, Re, Re, Re, Rd, Rd^Vyb, Wo, Wo, Wo, Wo, Wo, Wo, Wo, Wo, Wo
Wo, Wo, Xom, Xom, Re, Xom, Xom, Wo, Wo, Wo, Xom, Re, Re, Xom, Re, Re, Re, Rd, Rd^Vyb, Wo, Wo, Wo, Wo, Wo, Wo, Wo
Wo, Wo, Rd, Re, Re, Re, Rd, Wo, Wo, Wo, Wo^Bp/, Rd^Vyb, Rd, Re, Re, Re, Xom, Re, Re, Rd, Rd, Wo, Wo, Wo, Wo, Wo
Wo, Wo, Rd, Re, Xom, Re, Rd, Wo, Wo^Bp/, Wo^Bp/, Wo, Wo, Wo^Bp/, Rd^Vyb, Rd, Re, Re, Re, Ce, Ce, Ce, Rd, Xom, Wo, Wo, Wo
Wo, Wo, Rd, Re, Re, Re, Rd^Vyb, Wo^Bp/, Wo, Wo, Wo^Bp/, Wo^Bp/, Wo, Wo, Wo, Rd^Vyb, Rd, Re, Ce, 2 Ke, Ce, Iwr, Xom, Wo, Wo, Wo
Wo, Wo, Rd, Re, Ce, Re, Rd, Wo, Wo^Bp/, Wo^Bp/, Wo, Wo, Wo, Wo, Wo, Wo, Wo, Rd, Rd, Ce, Iwr, Iwr^Vyb, Xom, Wo, Wo, Wo
Wo, Wo, Rd, Ce, 3 Ke, Ce, Rd^Vyb, Wo^Bp/, Wo, Wo, Wo, Wo, Wo, Wo, Wo, Wo, Wo, Wo, Wo, Rd, Xom, Xom, Wo, Wo, Wo, Wo
Wo, Wo, Rd, Ce, Ce, Ce, Rd, Wo, Wo, Wo, Wo, Wo, Wo, Wo, Wo, Wo, Wo, Wo, Wo, Wo, Wo, Wo, Wo, Wo, Wo, Wo
Wo, Wo, Xom, Iwr, Iwr^Vyb, Iwr, Xom, Wo, Wo, Wo, Wo, Wo, Wo, Wo, Wo, Wo, Wo, Wo, Wo, Wo, Wo, Wo, Wo, Wo, Wo, Wo
Wo, Wo, Wo, Xom, Xom, Xom, Wo, Wo, Wo, Wo, Wo, Wo, Wo, Wo, Wo, Wo, Wo, Wo, Wo, Wo, Wo, Wo, Wo, Wo, Wo, Wo
Wo, Wo, Wo, Wo, Wo, Wo, Wo, Wo, Wo, Wo, Wo, Wo, Wo, Wo, Wo, Wo, Wo, Wo, Wo, Wo, Wo, Wo, Wo, Wo, Wo, Wo
Wo, Wo, Wo, Wo, Wo, Wo, Wo, Wo, Wo, Wo, Wo, Wo, Wo, Wo, Wo, Wo, Wo, Wo, Wo, Wo, Wo, Wo, Wo, Wo, Wo, Wo
Wo, Wo, Wo, Wo, Wo, Wo, Wo, Wo, Wo, Wo, Wo, Wo, Wo, Wo, Wo, Wo, Wo, Wo, Wo, Wo, Wo, Wo, Wo, Wo, Wo, Wo
