Wo, Wo, Wo, Wo, Wo, Wo, Wo, Wo, Wo, Wo, Wo, Wo, Wo, Wo, Wo, Wo, Wo, Wo, Wo, Wo, Wo, Wo, Wo, Wo, Wo, Wo, Wo, Wo, Wo, Wo, Wo, Wo
Wo, Wo, Wo, Wo, Wo, Wo, Wo, Wo, Wo, Wo, Wo, Wo, Wo, Wo, Wwr, Wo, Wo, Wo, Wo, Wo, Wo, Wo, Wo, Wo, Wo, Wo, Wo, Wo, Wo, Wo, Wo, Wo
Wo, Wo, Wo, Wo, Wo, Wo, Wo, Wo, Wo, Wo, Wo, Wo, Xue, Xue, Ds, Ds, 1 Ds, Wo, Ds, Wo, Wo, Wo, Wo, Wo, Wo, Wo, Wo, Wo, Wo, Wo, Wo, Wo
Wo, Wo, Wo, Wo, Wo, Wo, Wo, Wo, Wo, Wo, Xue, Xue, Xue, Xue, Xue, Ds, Rd, Ds, Ds, Xue, Xue, Wo, Wo, Wo, Wo, Wo, Wo, Wo, Wo, Wo, Wo, Wo
Wo, Wo, Wo, Wo, Wo, Wo, Xue, Xue, Xue, Xue, Xue, Xue, Xue, Xue, Xue, Xue, Uue^Es, Rd, Xue, Xue, Xue, Xue, Xue, Wo, Wo, Wo, Xue, Wo, Wo, Wo, Wo, Wo
Wo, Wo, Wo, Wo, Xue, Xue, Xue, Xue, Xue, Xue, Xue, Xue, Xue, Xue, Xue, Uhe, Uue^Em, Uue, Xue, Xue, Xue, Xue, Xue, Xue, Xue, Xue, Xue, Xue, Xue, Wo, Wo, Wo
Wo, Wo, Xue, Xue, Xue, Xue, Xue, Xue, Xue, Xue, Xue, Xue, Xue, Xue, Xue, Uue^Tf, Uhe, Xue, Xue, Xue, Xue, Xue, Xue, Xue, Xue, Xue, Wwg, Xue, Xue, Xue, Xue, Xue
Xue, Xue, Xue, Xue, Xue, Xue, Xue, Xue, Xue, Xue, Xue, Xue, Xue, Xue, Xue, Uue^Em, Uue^Es, Xue, Xue, Xue, Xue, Xue, Xue, Xue, Qxe, Wwg, Dd^Em, Wwg, Wwg, Xue, Xue, Xue
Xue, Xue, Xue, Xue, Xue, Xue, Uue, Xue, Xue, Xue, Xue, Xue, Xue, Xue, Uue^Em, Uue, Uue, Uue, Xue, Xue, Xue, Xue, Xue, Xue, Xue, Wwg, Wwg, Dd^Es, Wwg, Qxe, Xue, Xue
Xue, Xue, Xue, Xue, Uue^Tf, Uue^Tf, Uue, Uue, Rd, Xue, Xue, Xue, Xue, Uue^Tf, Uue^Es, Uue^Vud, Xue, Rd, Rd, Xue, Xue, Xue, Xue, Xue, Xue, Wog, Wwg, Dd^Em, Wwg, Wwg, Xue, Xue
Xue, Xue, Xue, Uue, Uue, Uue^Em, Xue, Xue, Xue, Uhe, Xue, Xue, Uue^Es, Rd, Xue, Xue, Xue, Xue, Xue, Uue^Es, Uue, Xue, Uue, Uue^Es, Uhe, Xue, Xue, Xue, Xue, Uue^Tf, Xue, Xue
Xue, Xue, Uue, Rd, Xue, Xue, Xue, Xue, Xue, Rd, Uue, Uue, Uhe, Uue^Tf, Xue, Xue, Xue, Xue, Xue, Uhe, Uue^Es, Uue, Xue, Uue, Uue, Uue, Xue, Xue, Xue, Uue^Es, Xue, Xue
Xue, Xue, Uue^Em, Uue, Xue, Xue, Xue, Xue, Xue, Xue, Uue, Uue^Es, Xue, Xue, Xue, Xue, Xue, Xue, Xue, Xue, Uue, Uhe, Xue, Xue, Uue, Uue, Rd, Xue, Uue, Rd, Xue, Xue
Xue, Xue, Uue^Es, Uhe, Xue, Xue, Xue, Xue, Uue, Xue, Uue^Em, Uue, Uue^Tf, Xue, Uue, Uue, Rd^Em, Uue^Tf, Rd, Uue, Uue^Es, Xue, Xue, Xue, Rd, Uue^Tf, Xue, Uue^Es, Uue, Xue, Xue, Xue
Uue^Tf, Rd, Xue, Xue, Xue, Xue, Uue, Uue^Es, Xue, Rd, Rd^Es, Rd, Rd, Rd^Em, Xue, Xue, Xue, Uhe, Xue, Uue, Uue, Xue, Xue, Xue, Uhe, Xue, Xue, Xue, Uue^Vu, Xue, Xue, Xue
Uue^Es, Uue, Xue, Xue, Xue, Uhe, Uue^Tf, Xue, Xue, Xue, Xue, Uhe, Rd^Es, Uue^Tf, Xue, Xue, Xue, Xue, Xue, Xue, Rd, Xue, Xue, Xue, Rd, Xue, Xue, Xue, Xue, Rd, Xue, Xue
Xue, Uue, Xue, Xue, Xue, Uue^Es, Hd, Xue, Xue, Xue, Xue, Xue, Xue, Xue, Xue, Xue, Cer, Xue, Xue, Xue, Uue^Tf, Uue^Tf, Xue, Xue, Uue, Uue, Uue^Es, Xue, Uue^Tf, Uue^Es, Xue, Xue
Xue, Rd, Xue, Xue, Xue, Ds, Ww, Ww, Ww, Ww, Ww, Xue, Xue, Xue, Xue, Cer, Ker, Cer, Xue, Xue, Xue, Rd^Em, Uue^Tf, Uue^Tf, Uue, Uue, Xue, Rd, Uue, Uue, Xue, Xue
Xue, Rd, Xue, Xue, Ww, Ww, Ha, Ha, Ms^Xm, Ms, Ms^Xm, Ww, Xue, Xue, Xue, Cer, Uue, Cer, Xue, Xue, Xue, Uue, Uue, Uue^Tf, Xue, Xue, Xue, Xue, Uue, Uue, Xue, Xue
Xue, Rd, Xue, Xue, Ww, Ms, Ms^Xm, Ha, Ms^Xm, Ha, Wwr, Ww, Ww, Xue, Xue, Xue, Rd, Xue, Xue, Xue, Uue^Es, Uue, Uue^Es, Uue, Xue, Xue, Xue, Xue, Uhe, Uue, Xue, Xue
Uue, Uue, Xue, Xue, Ww, Ms, Ms, Ms, Ha, Ms, Ww, Ww, Ww^Vm, Xue, Xue, Xue, Uhe, Uue^Em, Rd, Xue, Uue, Rd, Rd, Xue, Xue, Xue, Xue, Xue, Uhe, Rd, Xue, Xue
Uue^Em, Uue^Vu, Xue, Xue, Xue, Ww, Ww, Ha, Wwr, Ms, Ww, Ww, Xue, Xue, Xue, Rd, Xue, Xue, Xue, Rd, Rd^Es, Uue^Vu, Rd, Uhe, Xue, Xue, Xue, Xue, Rd, Rd, Xue, Xue
Uhe, Uue^Es, Rd, Xue, Xue, Ww, Ww, Ww, Ww, Ww, Ww, Xue, Xue, Xue, Uhe, Uue^Tf, Xue, Xue, Xue, Uhe, Uue^Tf, Uue^Em, Uhe, Rd, Uue, Xue, Uue, Uue, Uhe, Uhe, Xue, Xue
Xue, Xue, Rd^Es, Xue, Xue, Xue, Xue, Ww, Ww, Ww, Ww, Xue, Xue, Xue, Uue, Uue^Em, Xue, Xue, Xue, Xue, Xue, Uue^Tf, Xue, Uue^Es, Uue, Rd, Xue, Uue^Es, Xue, Xue, Xue, Xue
Xue, Xue, Xue, Rd, Uhe, Xue, Xue, Ds, Ww, Ww, Ww, Ds, Ds, Xue, Ds, Xue, Xue, Xue, Xue, Xue, Xue, Xue, Xue, Xue, Uue, Xue, Xue, Xue, Xue, Xue, Xue, Xue
Xue, Xue, Xue, Xue, Uue^Es, Xue, Ds, Ds, Wo, Wo, Wo, Wo, Wo, Ds, Wwr, Ds, Ds, Xue, Xue, Xue, Ds^Tfi, Xue, Xue, Xue, Ds, Xue, Ds, Xue, Wo, Xue, Xue, Xue
Xue, Xue, Wo, Xue, Ds, Ds, Wo, Wo, Wo, Wo, Wo, Wo, Wo, Wo, Wo, Wo, Wo, Ds, Ds, Ds, Ds, Xue, Ds, Ds, Wo, Ds, Wo, Wo, Wo, Wo, Wo, Wo
Wo, Wo, Wo, Wo, Wo, Wo, Wo, Wo, Wo, Wo, Wo, Wo, Wo, Wo, Wo, Wo, Wo, Wo, Wo, Wo, Wo, Wwr, Wo, Wo, Wo, Wo, Wo, Wo, Wo, Wo, Wo, Wo
Wo, Wo, Wo, Wo, Wo, Wo, Wo, Wo, Wo, Wo, Wo, Wo, Wo, Wo, Wo, Wo, Wo, Wo, Wo, Wo, Wo, Wo, Wo, Wo, Wo, Wo, Wo, Wo, Wo, Wo, Wo, Wo
Wo, Wo, Wo, Wo, Wo, Wo, Wo, Wo, Wo, Wo, Wo, Wo, Wo, Wo, Wo, Wo, Wo, Wo, Wo, Wo, Wo, Wo, Wo, Wo, Wo, Wo, Wo, Wo, Wo, Wo, Wo, Wo
