Wo, Wo, Wo, Wo, Wo, Wo, Wo, Wo, Wo, Wo, Ww, Wo, Wo, Wo, Ww, Wo, Ww, Wo, Wo, Wo, Wo, Wo
Wo, Wo, Wo, Wo, Wo, Wo, Wo, Wo, Wo, Wo, Ww, Wo, Wo, Wo, Ww, Wo, Ww, Wo, Wo, Wo, Wo, Wo
Wo, Wo, Wo, Wo, Wo, Wo, Wo, Wo, Ww, Ww, Aa, Ww, Ww, Ww, Aa, Ww, Aa, Ww, Wo, Wo, Wo, Wo
Wo, Wo, Wo, Wo, Ww, Ww, Ww, Ww, Aa, Aa, Aa, Aa, Ai, Aa, Aa^Vwm, Aa, Ww, Ww, Wo, Wo, Wo, Wo
Wo, Wo, Wo, Wo, Ww, Aa, Aa, Aa, Aa, Aa^Vwm, Rra, Rra, Rra, Aa, Aa, Aa, Ww, Wo, Wo, Wo, Wo, Wo
Wo, Wo, Wo, Wo, Ww^Bw\, Aa, Cha, Cha, Cha, Rra, Aa, Aa, Aa, Rra, Rra, Aa, Ai, Ww, Wo, Wo, Wo, Wo
Wo, Wo, Wo, Wo, Wo, Aa^Vwm, Cha, 2 Kva, Cha, Aa, Ha, Ha, Ha, Aa, Aa, Rra, Aa, Ww, Wo, Wo, Wo, Wo
Wo, Wo, Wo, Wo, Ww, Ww, Aa, Cha, Aa, Aa, Ha, Ms, Ms, Ha, Aa, Rra, Aa, Ww, Ww, Wo, Wo, Wo
Wo, Wo, Wo, Ww, Aa, Ai, Aa, Rra, Rra, Aa, Ha, Ms, Ha, Ha, Rra, Rra, Aa, Aa, Ww, Wo, Wo, Wo
Wo, Wo, Wo, Ww, Aa, Aa, Aa, Aa^Vwm, Rra, Aa, Aa, Ha, Aa, Ha, Rra, Aa, Aa, Aa, Ww, Ww, Wo, Wo
Wo, Wo, Ww, Ww, Ai, Aa, Aa, Aa, Aa, Rra, Rra, Aa, Rra, Aa^Vwm, Rra, Rra, Aa, Aa, Aa^Vwm, Ww, Wo, Wo
Wo, Wo, Ww, Ai, Ai, Ai, Ai, Aa, Aa, Aa, Aa, Rra, Aa, Rra, Aa, Rra, Aa, Aa, Aa, Ww, Wo, Wo
Wo, Wo, Wo, Aa, Aa, Ai, Ai, Ai, Ai, Aa^Vwm, Ai, Aa, Aa, Aa, Aa, Rra, Aa, Aa, Aa, Ww, Wo, Wo
Wo, Wo, Wo, Aa, Aa, Aa^Vla, Aa, Ai, Ai, Ai, Aa, Ai, Ai, Aa, Aa, Rra, Cea, Aa, Ww, Ww, Wo, Wo
Wo, Wo, Aa, Ai, Ai, Ai, Ai, Aa, Ai, Aa, Ai, Ai, Ww, Aa, Cea, Cea, Cea, Aa^Vha, Ww^Bw\, Ww, Wo, Wo
Wo, Wo, Aa, Ai, Aa, Aa, Aa, Ai, Aa, Aa, Aa^Vla, Aa, Wo, Ww, Aa, 1 Kea, Ai, Aa, Ww, Wo, Wo, Wo
Wo, Wo, Aa, Ai, Aa, Aa^Vla, Aa, Ai, Ai, Ai, Ai, Aa, Wo, Ww, Aa, Aa, Ww, Ww, Wo, Wo, Wo, Wo
Wo, Wo, Aa, Ai, Ai, Ai, Ai, Ai, Aa, Aa, Aa, Aa, Wo, Ww, Ww, Aa, Ww, Ww, Wo, Wo, Wo, Wo
Wo, Wo, Wo, Aa, Aa, Ai, Ai, Aa, Wo, Wo, Wo, Wo, Wo, Wo, Wo, Ww, Wo, Wo, Wo, Wo, Wo, Wo
Wo, Wo, Wo, Wo, Wo, Aa, Wo, Wo, Wo, Wo, Wo, Wo, Wo, Wo, Wo, Wo, Wo, Wo, Wo, Wo, Wo, Wo
Wo, Wo, Wo, Wo, Wo, Wo, Wo, Wo, Wo, Wo, Wo, Wo, Wo, Wo, Wo, Wo, Wo, Wo, Wo, Wo, Wo, Wo
Wo, Wo, Wo, Wo, Wo, Wo, Wo, Wo, Wo, Wo, Wo, Wo, Wo, Wo, Wo, Wo, Wo, Wo, Wo, Wo, Wo, Wo
