border_size=1
usage=map

Wo          , Wo          , Wo          , Wo          , Wo          , Wo          , Wo          , Wo          , Wo          , Wo          , Wo          , Wo          , Wo          , Wo          , Wo          , Wo          , Wo          , Wo          , Wo          , Wo          , Wo          , Wo          
Wo          , Wo          , Wo          , Wo          , Wo          , Wo          , Wo          , Wo          , Wo          , Wo          , Wo          , Wo          , Wo          , Wo          , Wo          , Wo          , Wo          , Wo          , Wo          , Wo          , Wo          , Wo          
Wo          , Wo          , Wo          , Wo          , Wo          , Wo          , Wo          , Wo          , Wo          , Wo          , Wo          , Wo          , Wo          , Wo          , Wo          , Wo          , Wo          , Wo          , Wo          , Wo          , Wo          , Wo          
Wo          , Wo          , Wo          , Wo          , Wo          , Wo          , Xu          , Xu          , Rb          , Wo          , Wo          , Wo          , Wo          , Wo          , Wo          , Wo          , Wo          , Wo          , Wo          , Wo          , Wo          , Wo          
Wo          , Wo          , Wo          , Wo          , Wo          , Xu          , Rb          , Rb          , Ce          , Rd          , Rd          , Wo          , Wo          , Wo          , Wo          , Wo          , Wo          , Wo          , Wo          , Wo          , Wo          , Wo          
Wo          , Wo          , Wo          , Wo          , Wo          , Xu          , Rb          , Ce          , 1 Ke        , Ce          , Rb          , Rd          , Rd          , Wo          , Wo          , Wo          , Wo          , Wo          , Wo          , Wo          , Wo          , Wo          
Wo          , Wo          , Wo          , Wo          , Wo          , Xu          , Rb          , Ce          , Ce          , Ce          , Rb          , Rb          , Rb          , Rd          , Rd          , Wo          , Wo          , Wo          , Wo          , Wo          , Wo          , Wo          
Wo          , Wo          , Wo          , Wo          , Wo          , Wo          , Wo          , Rd          , Rd^Vyb      , Rb          , Rb          , Rb          , Xu          , Rb          , Rb          , Rd          , Rd          , Wo          , Wo          , Wo          , Wo          , Wo          
Wo          , Wo          , Wo          , Wo          , Wo          , Wo          , Wo          , Wo          , Ww^Bw|      , Rd          , Rd^Vyb      , Rb          , Rb          , Rb          , Rb          , Rb          , Rb          , Rd          , Xu          , Wo          , Wo          , Wo          
Wo          , Wo          , Wo          , Wo          , Xu          , Wo          , Wo          , Wo          , Ww^Bw|      , Wo          , Ww^Bw|      , Rd          , Rd          , Rb          , Rb          , Xu          , Rb          , Rb          , Xu          , Wo          , Wo          , Wo          
Wo          , Wo          , Xu          , Xu          , Rb          , Rd          , Rd          , Wo          , Ww^Bw|      , Wo          , Ww^Bw|      , Wo          , Wo          , Rd          , Rd          , Rb          , Rb          , Rb          , Xu          , Wo          , Wo          , Wo          
Wo          , Wo          , Xu          , Rb          , Rb          , Rb          , Rb          , Rd          , Rd^Vyb      , Wo          , Ww^Bw|      , Wo          , Wo          , Wo          , Wo          , Rd          , Xu          , Xu          , Wo          , Wo          , Wo          , Wo          
Wo          , Wo          , Xu          , Rb          , Rb          , Rb          , Rb          , Rb          , Rb          , Rd          , Rd^Vyb      , Wo          , Wo          , Wo          , Wo          , Wo          , Wo          , Wo          , Wo          , Wo          , Wo          , Wo          
Wo          , Wo          , Wo          , Rd          , Rd          , Rb          , Rb          , Xu          , Rb          , Rb          , Rb          , Rd          , Xu          , Xu          , Xu          , Wo          , Wo          , Wo          , Wo          , Wo          , Wo          , Wo          
Wo          , Wo          , Wo          , Wo          , Wo          , Rd          , Rd          , Rb          , Rb          , Rb          , Xu          , Rb          , Rb          , Rb          , Rb          , Xu          , Xu          , Wo          , Wo          , Wo          , Wo          , Wo          
Wo          , Wo          , Wo          , Wo          , Wo          , Wo          , Wo          , Rd          , Rd          , Rb          , Rb          , Rb          , Ce          , Ce          , Ce          , Rb          , Xu          , Wo          , Wo          , Wo          , Wo          , Wo          
Wo          , Wo          , Wo          , Wo          , Wo          , Wo          , Wo          , Wo          , Wo          , Rd          , Xu          , Rb          , Ce          , 2 Ke        , Ce          , Rb          , Xu          , Wo          , Wo          , Wo          , Wo          , Wo          
Wo          , Wo          , Wo          , Wo          , Wo          , Wo          , Wo          , Wo          , Wo          , Wo          , Xu          , Rb          , Rb          , Ce          , Rb          , Re^Vyb      , Xu          , Wo          , Wo          , Wo          , Wo          , Wo          
Wo          , Wo          , Wo          , Wo          , Wo          , Wo          , Wo          , Wo          , Wo          , Wo          , Wo          , Xu          , Xu          , Rb          , Xu          , Xu          , Wo          , Wo          , Wo          , Wo          , Wo          , Wo          
Wo          , Wo          , Wo          , Wo          , Wo          , Wo          , Wo          , Wo          , Wo          , Wo          , Wo          , Wo          , Wo          , Xu          , Wo          , Wo          , Wo          , Wo          , Wo          , Wo          , Wo          , Wo          
Wo          , Wo          , Wo          , Wo          , Wo          , Wo          , Wo          , Wo          , Wo          , Wo          , Wo          , Wo          , Wo          , Wo          , Wo          , Wo          , Wo          , Wo          , Wo          , Wo          , Wo          , Wo          
Wo          , Wo          , Wo          , Wo          , Wo          , Wo          , Wo          , Wo          , Wo          , Wo          , Wo          , Wo          , Wo          , Wo          , Wo          , Wo          , Wo          , Wo          , Wo          , Wo          , Wo          , Wo          
